Takedowns = 처치, 킬 + 어시
Deaths = 죽음
TownKills = 
SoloKill = 결정타(킬)
Assists = 어시
MetaExperience = 팀 총 경험치?, 팀원 모두 동일
Level = 레벨, 팀원 모두 동일
TeamTakedowns = 팀 총 처치, 0,5에만 값이 있음
ExperienceContribution = 경험치 기여
Healing = 팀원한테 준 힐량, 보호막
SiegeDamage = 공성 데미지
StructureDamage = 건물에게 준 데미지
MinionDamage = 돌격병에게 준 데미지
HeroDamage = 영웅에게 준 데미지
MercCampCaptures = 용병 캠프 획득
WatchTowerCaptures = 시야탑 획득
SelfHealing = 자힐
TimeSpentDead = 죽어있는 시간
TimeCCdEnemyHeroes = 상대에게 군중 제어기를 적용한 시간
CreepDamage = 
SummonDamage = 
Tier1Talent = 1렙 특성
Tier2Talent = 4렙 특성
Tier3Talent = 7렙 특성
Tier4Talent = 10렙 특성
Tier5Talent = 13렙 특성
Tier6Talent = 16렙 특성
Tier7Talent = 20렙 특성
DamageTaken = 받은 데미지
DamageSoaked
KilledTreasureGoblin = 이벤트관련
HighestKillStreak = 최고 연속 처치 수
TeamLevel = 레벨, 팀원 모두 동일
ProtectionGivenToAllies = 팀원에게 준 보호막
TimeSilencingEnemyHeroes = 상대편 침묵 시간
TimeRootingEnemyHeroes = 상대편 속박 시간
TimeStunningEnemyHeroes = 상대편 기절 시간
ClutchHealsPerformed = 죽기 직전에 힐한 횟수
EscapesPerformed = 딸피로 살아난 횟수
VengeancesPerformed = 복수한 죽음 수
TeamfightEscapesPerformed = 한타 중 딸피로 살아난 횟수
OutnumberedDeaths = 수적으로 열세인 동안 죽은 수
TeamfightHealingDone = 한타 중 힐
TeamfightDamageTaken = 한타 중 받은 데미지
TeamfightHeroDamage = 한타 중 적 영웅에게 준 데미지
LessThan4Deaths = 4데스 미만
LessThan3TownStructuresLost = 건물 파괴 2개 이하

PhysicalDamage = 평타 데미지 + 물리 데미지 특성
SpellDamage = 스킬 데미지 + 스킬 데미지 특성
Multikill = 연속킬 횟수
MinionKills = 돌격병 죽인 횟수
RegenGlobes = 재생의 구슬 획득 수
OnFireTimeOnFire = 불타는 시간 

EndOfMatchAwardMVPBoolean = 엠비피
EndOfMatchAwardHighestKillStreakBoolean = 연속 처치 
EndOfMatchAwardMostVengeancesPerformedBoolean = 복수자
EndOfMatchAwardMostDaredevilEscapesBoolean = 죽음의 위기에서 살아남
EndOfMatchAwardMostEscapesBoolean = 최고 탈출 횟수???
EndOfMatchAwardMostXPContributionBoolean = 최고 경험치 기여
EndOfMatchAwardMostHeroDamageDoneBoolean = 최고 영웅뎀
EndOfMatchAwardMostKillsBoolean = 최다 킬
EndOfMatchAwardHatTrickBoolean = 첫 킬 삼연속
EndOfMatchAwardClutchHealerBoolean = 죽기 직전에 힐 줌
EndOfMatchAwardMostProtectionBoolean = 최고 보호량
EndOfMatchAward0DeathsBoolean = 0데스
EndOfMatchAwardMostSiegeDamageDoneBoolean = 최고 공성뎀
EndOfMatchAwardMostDamageTakenBoolean = 최고 고기방패
EndOfMatchAward0OutnumberedDeathsBoolean = 수적으로 열세인동안 죽지 않음
EndOfMatchAwardMostHealingBoolean = 최고 힐량
EndOfMatchAwardMostStunsBoolean = 최고 기절 시간
EndOfMatchAwardMostRootsBoolean = 최고 속박 시간
EndOfMatchAwardMostSilencesBoolean = 최고 침묵 시간
EndOfMatchAwardMostMercCampsCapturedBoolean = 가장 용병캠프 많이 먹음



EndOfMatchAwardMostTeamfightDamageTakenBoolean = 한타 중 최고 고기방패
EndOfMatchAwardMostTeamfightHealingDoneBoolean = 한타 중 최고 힐량
EndOfMatchAwardMostTeamfightHeroDamageDoneBoolean = 한타 중 최고 영웅 데미지
EndOfMatchAwardMostDamageToMinionsBoolean = 돌격병에게 가장 많은 데미지를 준 사람??


EndOfMatchAwardMapSpecificBoolean = 맵 특수 

EndOfMatchAwardMostDragonShrinesCapturedBoolean = 용의 둥지, 가장 용 신단 많이 먹은 사람
EndOfMatchAwardMostTimePushingBoolean = 하나무라, 가장 오래 화물 민 사람

EndOfMatchAwardMostTimeOnPointBoolean = 볼스카야 공장, 가장 오래 점령 하고 있던 사람
TimeOnPoint = 점령 시간

EndOfMatchAwardMostInterruptedCageUnlocksBoolean = 알터랙 고개, 가장 감옥 해체 방해를 많이 한 사람
CageUnlocksInterrupted = 감옥 해체 방해

EndOfMatchAwardMostSeedsCollectedBoolean = 공포의 정원, 가장 씨앗을 많이 먹은 사람
EndOfMatchAwardMostDamageToPlantsBoolean = 옛날 공포의 정원, 정원공포에게 가장 많은 데미지를 준 사람
GardenSeedsCollectedByPlayer = 씨앗 획득

EndOfMatchAwardMostCurseDamageDoneBoolean = 저주받은 골짜기, 저주 중 가장 많은 데미지를 준 사람
RavenTributesCollected = 공물 획득 수
CurseDamageDone = 저주 동안 준 데미지

EndOfMatchAwardMostCoinsPaidBoolean = 블랙하트 항만, 금화를 가장 많이 입금한 사람

EndOfMatchAwardMostImmortalDamageBoolean = 영원의 전쟁터, 불멸자에게 가장 많은 데미지를 준 사람

EndOfMatchAwardMostDamageDoneToZergBoolean = 브락시스 항전, 가장 저그에게 많은 피해를 준 사람


EndOfMatchAwardMostTimeInTempleBoolean = 하늘 사원, 가장 오랫동안 사원을 점령한 사람

EndOfMatchAwardMostGemsTurnedInBoolean = 거미 여왕의 무덤, 보석을 가장 많이 입금한 사람

EndOfMatchAwardMostSkullsCollectedBoolean = 죽음의 광산, 가장 많은 해골을 획득한 사람

EndOfMatchAwardMostAltarDamageDone = 죽음의 탑, 신단으로 데미지를 가장 많이 준 사람

EndOfMatchAwardMostNukeDamageDoneBoolean = 핵탄두 격전지, 핵으로 가장 많이 데미지를 준 사람


TeamWinsDiablo = 디아블로 캐릭터로 승리
TeamWinsFemale = 여성 캐릭터로 승리
TeamWinsMale = 남성 캐릭터로 승리
TeamWinsStarCraft = 스타크래프트 캐릭터로 승리
TeamWinsWarcraft = 워크래프트 캐릭터로 승리
WinsWarrior = 전사로 승리
WinsAssassin = 암살자로 승리
WinsSupport = 지원가로 승리
WinsSpecialist = 전문가로 승리

WinsStarCraft = 스타크래프트 캐릭터로 승리
WinsDiablo = 디아블로 캐릭터로 승리
WinsWarcraft = 워크래프트 캐릭터로 승리
WinsMale = 남성 캐릭터로 승리
WinsFemale = 여성 캐릭터로 승리

PlaysStarCraft = 스타크래프트 캐릭터로 플레이
PlaysDiablo = 디아블로 캐릭터로 플레이
PlaysOverwatch = 오버워치 캐릭터로 플레이
PlaysWarCraft = 워크래프트 캐릭터로 플레이

PlaysWarrior = 전사로 플레이
PlaysAssassin = 암살자로 플레이
PlaysSupport = 지원가로 플레이
PlaysSpecialist = 전문가로 플레이
PlaysMale = 남성 캐릭터 플레이
PlaysFemale = 여성 캐릭터 플레이

Role = 다 0
EndOfMatchAwardGivenToNonwinner = 다 0

GameScore = 다 0
LunarNewYearSuccesfulArtifactTurnIns = 이벤트
LunarNewYearEventCompleted = 이벤트
StarcraftDailyEventCompleted = 이벤트
StarcraftPiecesCollected = 이벤트
LunarNewYearRoosterEventCompleted = 이벤트
PachimariMania = 이벤트

TouchByBlightPlague

